111111111111111111111111
10CCCCCC0011111111111111
10ECXX111111111111111111
1CP00X111111111111111111
111111111111111111111111